                                                  v#..#.....#.................................................................^...#...........#......
                                                  <...............#.....#......#...#................#..........#.#...........#^<<<<<<<<<<<<<<<<<<<<<<
                                                  #............#..#.......................##..................................^#.........#.........#.
                                                  #......#.......##..#...#....##..............#.....#....#...........#.#......#......................
                                                  #.....#.#...#......#..........#.........................#..#........#................#.........#...
                                                  .....#....#..............##.......#...........#.#............#..........#............#...#.........
                                                  ....#......#.......#..........#.................#.....#.......#.....#.........#...#.#..............
                                                  .........#............#..................##........#......#........................................
                                                  .............#......#....#.#..................#.....................................#.....#...#....
                                                  .....#..........##...........#.#..............................##..........#.....................#..
                                                  #............................#..#.......#.....#.......................#............................
                                                  ..##...........#...#............#.....#.#...#.....#...................#...#........................
                                                  ..#.....#..............................................................##.......#..................
                                                  ..##......#.....#......#..#..................#..........................#.......##.....#....#......
                                                  ..........#.....#.....#.........#.#....#....#..#.............#.........#.......#...#......#.....#..
                                                  #...#........#.....#....................##...........#.#.......#.#..............................##.
                                                  .....#.......#.......#..........#...#.........#..#............#..#......#............#.........#...
                                                  .......#...#............#...................................................................#......
                                                  ...........................#.............#..........#.........#..#......................#..###...#.
                                                  ................#..#..............#....#....#.....###.#........#.#...#...............#.....#.......
                                                  ....#........................................#....#................#...##.#...............##.......
                                                  #..................#.............#................#............#......#..#......#.......#..........
                                                  .#.............#.#...............#...##.#.#...............#...#....#..#............................
                                                  ........#........................#..#.#.............#.............##...........#..#.....#..........
                                                  ..............#..........#.....#................##.............#.......#.......#.#.................
                                                  ..##.#.#..#...#.........................#....#.........................#.............##............
                                                  ...#..............................#........................................#.....................#.
                                                  #.........##...#....................................................................#..............
                                                  ..##........#...#..................#.............................#..........................#......
                                                  ....#...#.........................................##...#.......................#...#.#........#....
                                                  ##......#.##........#....#.....#..............#....#........................#..#...#...............
                                                  ........#..............#.#......#...#........#................................#.......#....##......
                                                  ..#..#.........................#.......#.......#................#.........#.............#.....#....
                                                  ......#......#..............#....#......................#................#....#.........#..........
                                                  ..#..............................#......##...#.................#..........##...#.#..........#......
                                                  ........#.............#.........#......................#..##......................#................
                                                  #..#.....#...............#...............#..................................#.....#..#.............
                                                  .#..............#..#...#..#...................#..........................##....#...#..#.##.........
                                                  ...#.......#.#..........................#.....#.#...............#....#.................#..##.......
                                                  ....#..........#......#.....##.#.........#..###..................#.....................#...........
                                                  ..##.#...........#................#..#.......#.............#............#...#...#.....##......#....
                                                  #.#...............................#........................#................#.......#.#............
                                                  ................................#...#..#.....#............#..............#..>>>>>>>>>v#....#.......
                                                  .........#......#..................#......#..............#....#.............^........v...#.....#..#
                                                  ......#....##........#...........##.........................................^........v.............
                                                  .....#......................................#......#......#......#...#.....#^.......^<.......#.....
                                                  ........#..#.......................##......##.......#..............#........^........#..........#.#
                                                  ........................#........................#..........................^......................
                                                  ...#.#....#...........#......................#............#..#..#...........^................#.....
                                                  ...............................#.........#...................#..............^........#...........#.
                                                  ......#......#.......................#.........#..                                                 
                                                  ..........#..........#........#...................                                                 
                                                  ...#....#............................#...#........                                                 
                                                  ..........#.............#.....................#...                                                 
                                                  ....#......#.......#........#.##................##                                                 
                                                  ........#...#....#...#......#..#.....##.#.#.......                                                 
                                                  ...........#.#.........#..............#...........                                                 
                                                  ........................#...........#..#..........                                                 
                                                  .......###..............................#.......#.                                                 
                                                  #...................#....#.#..#..........#........                                                 
                                                  ...................#..#...........#.......#.......                                                 
                                                  #...#........##............#......#.....#.#.#.#...                                                 
                                                  ..#.........#........#............................                                                 
                                                  ...................#...............#..#...........                                                 
                                                  .........................#..#..............#......                                                 
                                                  ...........#....#.....#.#........#....#..#..#.....                                                 
                                                  .....#......#.........#......#........##.......#..                                                 
                                                  ..#......#.....#..........#...#....#.#......#.....                                                 
                                                  .....#...#.#................................#.....                                                 
                                                  ..................................................                                                 
                                                  ..........................#.......................                                                 
                                                  .#.#....#........#.#.......................#......                                                 
                                                  .#............#.....#.....#........#..............                                                 
                                                  #................#....................#.........#.                                                 
                                                  ..................................#....#..........                                                 
                                                  .#.#.....#..................#...#.................                                                 
                                                  .##.#.......#...#......#..........................                                                 
                                                  ...............#.......#..........................                                                 
                                                  ...#...#...#.#........#.........#.#.......#.##...#                                                 
                                                  .#..........#...#..............#.#................                                                 
                                                  .....##......##.......#.#.......................#.                                                 
                                                  ..................................................                                                 
                                                  #.........................#...##............#.....                                                 
                                                  .#.#................##.................#.........#                                                 
                                                  ...#...#.#....#........#....#.#.....#...##.....#..                                                 
                                                  ......####.........................#..............                                                 
                                                  .......#.......#.......#........#.......#..#......                                                 
                                                  ............#........#.#..#...........##.....#....                                                 
                                                  .....#.......#..#.........#...#.........#.........                                                 
                                                  ...#.##..#....................#............##.....                                                 
                                                  ..........#.............#..#......#....#...#.....#                                                 
                                                  ..#............#........#.....................#...                                                 
                                                  .............................#....................                                                 
                                                  #...#.......#.#............#.....#................                                                 
                                                  ...................................#.......#......                                                 
                                                  #.........................#........#.......#...#..                                                 
                                                  ......................#..#........................                                                 
                                                  ...............#....#....................#......#.                                                 
                                                  .......#................#....#.#............##....                                                 
                                                  ..........#.....#....................##.#..#....#.                                                 
.#.................#......##...#..#...#.#...#................#..................#...........#.......                                                 
#..........#..........#..........#.#..#................#.......#.....................#.............#                                                 
.............#..#..#......#.#...#..#................#...#.........#......#.....#......#.............                                                 
#...#...#................##...#.##...#................#....................#.#...##.................                                                 
.......................#.....................#............#.#...#.#.........................#.......                                                 
...............##...#.#...........................#................#................................                                                 
........#.........#.##..........................#..........#..........#.........#...#....##.........                                                 
............................#.....##...............#....#.....#..#..##.............#......#.........                                                 
........#.#..#..........................................##...#.#.....#.....................#....#...                                                 
........................#.#..#............................#...#...................#.................                                                 
........#.........................................#.........#...#..#.#..........#.............#...##                                                 
..................#..#..............###...#.....#.........................................###.#.....                                                 
.........#..#...#...#......##.....#..........#..............#....#............###.....#..#.......#..                                                 
.#....................................#.............#..........#..................#..#..........#...                                                 
...........#..#...............#...##......#.............#..............#........#............#......                                                 
....#...........#....##.#....................#........#..............#..........#..#.#........#.....                                                 
..#.....#...#......#.......#..#.....#.......#.............................#..#.....#................                                                 
.....#..#..#........##...........#...#.................#......#....#.....#.........#....##....#.....                                                 
...#.........................................##............##......#......................#.........                                                 
....#..........##..#.................#..............#.............###.........................#.....                                                 
...............#..#....#........##..#.....##...#...#.....#......#....##...##......#.#..........#....                                                 
....#...........#..#............#.............#....................#..#...........#.................                                                 
.....##...#........................#....#...............#..#...........#.........#.......#.#........                                                 
....##..#.......#................#........#.........#............#..................#.....#...##..#.                                                 
...........#.#..........#......#........#...#.#.....#.#...#.....#....#.........#....................                                                 
........#......#.#.#......#............#..........#.....#..#....#........#.#.....#.#..........#.....                                                 
.##.......#...#..............................#.......#.......#...#..#...............................                                                 
.#...#..##......#.#..#....##...............#...............#.......#....#...............#.......#...                                                 
..............#.............#.....#..........#.................#......#.......#....................#                                                 
#....#..#.....#..#.........#......#.##..............#.........#.....................................                                                 
#.#.......#......#..#......#....#...............................................#..................#                                                 
.............................................#...............#.#...#.......#.#.............#........                                                 
..........#...........#..#................#...........#....#........................................                                                 
.....#..#...............#.......##...............##....#.......#...............#..............#.#...                                                 
...#.........#...........................#..........#.#..........#.............#..#.....#.....#.#...                                                 
...........................#..#...........#..#....##....#...........##.................#...........#                                                 
............#........................#...#.#......#......#..........................................                                                 
..................#..............................................#......#................#...#..#...                                                 
##...#.#...#.##.#.....#.................#...##....##..........#.........................#...........                                                 
......#..#..#.....#....#.#....#.......................#......................##....................#                                                 
.....#.............#..................#..............#........#.....#.....#.#..........##...........                                                 
.........#......#......................#...........#.......#.##..#............#...........#.........                                                 
...#............#...##........#.......#......#...#..#..............#.#...........#......#......#....                                                 
........#........................##..#..........................#.....#.......#...............#.....                                                 
..........#.......#....#...#....#.........#..#.#.#.........#.........#......#............#........#.                                                 
..#............#......................#............#.........#..........#.....#............#........                                                 
.....#........#.........#.#..#.............#..#...#....#...#..........#...#.#.......##....#.....#...                                                 
....................#...##....................#....#..........#.#...#.......#...........#.#.........                                                 
...#......................#.#........#.......#....................#.......#.....##....#...#.........                                                 
...............#...............................#...#.............#......#..................#.......#                                                 
.#.......#..#....#.............###....#..#........                                                                                                   
#...#.......................................#.....                                                                                                   
..............#........#.........#............#.#.                                                                                                   
##..................#....#........................                                                                                                   
...............#....................#.....#..#.##.                                                                                                   
..#........#............#............#......#.....                                                                                                   
.......#.....#...#.....#.......#.........#........                                                                                                   
.............................................#....                                                                                                   
#...........#.....#...#............#......##....#.                                                                                                   
....#....#......#..#.....#...#..#......#........#.                                                                                                   
..........#...#...#............................#..                                                                                                   
....##...............#..............##......#...#.                                                                                                   
...##................#............#...#....#...#..                                                                                                   
.....##................#.....#..........#.........                                                                                                   
...#...#...........#..#.#...#......#....#.#.......                                                                                                   
.....#.........#..................#...............                                                                                                   
...#.........#.#..#.........#............#..#.....                                                                                                   
...#...#.#.#......................................                                                                                                   
#.......................##........#...............                                                                                                   
.........#...####........#.....#...#..............                                                                                                   
.............................................#....                                                                                                   
.................#...............................#                                                                                                   
........#..#...#.............................#....                                                                                                   
.........#.#......................................                                                                                                   
..............#.....##....#........#......#..#....                                                                                                   
....#....##....#..............#.......#...........                                                                                                   
..............................#.........#.#..#....                                                                                                   
......#..#......#........#.#......#......#....#...                                                                                                   
....#.................#.......#.....#.......#.....                                                                                                   
.............#.........##.#.......#..#..#.....#...                                                                                                   
.....#..#.......#......................#.....#....                                                                                                   
..........#........#...#.............#........##..                                                                                                   
.............................#..................#.                                                                                                   
...#...............#....#......................#..                                                                                                   
....................#........................#....                                                                                                   
..#..............#..#.............................                                                                                                   
....##...............#....#.......................                                                                                                   
....#.......#.......#...........#.....#...........                                                                                                   
........#..#........#.........###....#...#..##....                                                                                                   
.#....#.......#........#..........#........#..##..                                                                                                   
................#.........#........#.#......#.....                                                                                                   
........#.#....#..............#...................                                                                                                   
......#...........#..#............#.....#..#......                                                                                                   
.#......#.#........#....#.....#..........#..#.....                                                                                                   
........#...#...........#.......#.................                                                                                                   
...........#...#..##..#........................#..                                                                                                   
...#.....#.#.#..........................#...#.....                                                                                                   
....#......#.................#.....#.............#                                                                                                   
............#.#......#.......................#....                                                                                                   
